NO img/wall_north.xpm
SO img/wall_south.xpm
WE img/wall_west.xpm
EA img/wall_east.xpm
F 220,192,203
C 255,20,147



11111111111111111111111111111
1100000111010101111101111000111
11110111 1110101 101111010001
11111111 1111111 11111111111