NO img/wall_north.xpm
SO img/wall_south.xpm
WE img/wall_west.xpm
EA img/wall_east.xpm
F 220,192,203
C 255,20,147



11111111111111111111111111111                               1111111
100000000000000000000000000011                             10000W001
1111111111111111111100000000011                            100000001
10000000000000000000000000001                               11111111
1111111111111111111111111111