NO img/wall_north.xpm
SO img/wall_south.xpm
WE img/wall_west.xpm
EA img/wall_east.xpm
F 220,192,203
C 255,20,147


                  11111111111111111111111111111111111111111111111111111111
                 100000000000000000000000000000000000000000000000000000011
                1100000000001000000000000000001000000000111111111111111111
111111111111111100000000000000000000000000000000000000111
111111111111111100000000000000000000000000000000000000111
111111111111111100000000000000000000000000000000000000111
111111111111111000000000000000000000000000000000000000111
111111111111111100000000000000000000000000000000000000111
111111111111111100000000000000000000000000000000000000111
  11111111111111110000000000000000000000000000000000000111111
    11111111111111110000000000000000000000000000000000000011111
        111111111111111100000000000000000000000000000000000000111
            1111111111111000000000000000000000000000000000000111
                11000000000010000000000000000010000000001111111111111111
1111111111111111000000000000000000000000000000000000001111
111111111111111100000000000000000000000000000000000000111
111111111111111100000000000000000000000000000000000000111
111111111111111000000000000000000000000000000000000000111
111111111111111100000000000000000000000000000000000000111
1111111111111111000000000000000000000000000000000000001111
  111111111111111100000000000000000000000000000000000001111
    111111111111111100000000000000000000000000000000000000111
      111111111111111100000000000000000000000000000000000000111
        11111111111111110000000000W00000000000000000000000000011
        11111111111111111111111111111111111111111111111111111111