NO img/wall_north.xpm
SO img/wall_south.xpm
WE img/wall_west.xpm
EA img/wall_east.xpm
F 220,192,203
C 255,20,147
    

111111111111111111111111
100000000000000000001011
10000000W000000000000001
111111111111111111111111